###############################
##2    1      2   #####     3 #
#          ####      ##       #
#    1     ####       2       #
#          ####       ##   12 #
#    H     11         ##    ###
###############################